SHH___n___<H
_SS_S_SSSS__
____SBS__S__
____SBS__S__
_B__SSS_____
_____B_K_S__
_T_T_____S__
__BT_____Sn_
_TTT_____S__
______>_____
SSSSS_BBSSBS
_H__B_______
M___B___+__M
