K_T___M_
__T_T___
_MT____n
S_B_T>__
_BS_TSST
____TTTT
TS___<__
HS_M_-_M
BBS_S___
BBB>S__V
